R 800 600

NO    greystone.xpm

SO greystone.xpm

WE bluestone.xpm

EA purplestone.xpm

S pillar.xpm

F 255,0,0

C 117,214,255
1 E 1 1 1 1 1 1 1 1 1 1 1 1 1 1 1 1 1 1 1 1 1 1
1 0 0 0 0 0 0 0 0 0 0 0 0 0 0 0 0 0 0 0 0 0 0 1
1 0 0 0 0 0 0 0 0 0 0 0 0 0 0 0 0 0 0 0 0 0 0 1
1 0 0 0 0 0 0 0 0 E N 0 0 2 0 0 0 0 0 2 2 2 0 1
1 0 0 0 0 0 0 0 0 S W 0 0 0 0 0 0 0 0 2 W 2 0 1
1 0 0 0 0 0 0 0 0 0 0 0 0 0 0 0 0 0 0 0 0 0 0 1
1 1 1 1 1 1 1 1 1 1 1 1 1 1 1 1 1 1 1 1 1 1 1 1
